0
- demo: simple summing
1
- word_count: word counting
2
- expansion: count most occurence
- palindrome: search from middle
3
- bankcrisis: union find
- election: sort after linear time
4
- exploration: partial order, take away nodes with no inputs
- ipomc: inverse mst
- jerusalem trip: next free
5
- assignments: binary search
- punctuality: sssp single-source shortest path, positive weigts - Dijkstra 
- timetravel: apsp All-Pairs Shortest Paths, negative weights - Floyd-Warshall

7
- Blackout: dynamische Programmierung, beste Aufteilung für Preis
- IOPMC: Graphentraversierung, längster Pfad
- Mining: doppelt verkette Liste, rekursiv

8
- Garden: Berechnung aller kürzester Pfade
- pokerchips: rekursiv mit dyn prog
- students: find students groups with asking (not correct)

9
- atlas: dyn prog
- destructive art: convex hull
- umbridgerules: find shortest path - not working
- server: save servers in lists to find which are running at same time

11
- dhl: recursive find of best solution

12
- bachelorprojects: min cost
- picture: merge sort with count
- sculpture: cycle with all nodes

13
- summit: max flow
- collecting: all permutations

14
- ritual: find in 2d grid
